CA-SCB	Unforested bog
CA-SCC	Forested bog
DE-Hte	Unforested bog
DE-Zrk	Unforested bog
DE-SfN	Unforested bog
FI-Lom	Unforested bog
FI-Si2	Unforested bog
FI-Sii	Unforested bog
FR-LGt	Unforested bog
JP-BBY	Unforested bog
NZ-Kop	Unforested bog
RU-Ch2	Unforested bog
RU-Cok	Unforested bog
SE-Deg	Unforested bog
US-A03	Unforested bog
US-ICs	Unforested bog
US-A10	Unforested bog
US-Atq	Unforested bog
US-Beo	Unforested bog
US-Bes	Unforested bog
US-NGB	Unforested bog
US-BZB	Forested bog
US-BZF	Unforested bog
US-Uaf	Forested bog
US-Ivo	Unforested bog
US-Los	Unforested bog
US-NGC	Unforested bog
BR-Npw	Forested swamp
BW-Gum	Unforested swamp
BW-Nxr	Unforested swamp
ID-Pag	Forested swamp
MY-MLM	Forested swamp
US-NC4	Forested swamp
US-DPW	Unforested swamp
US-LA2	Unforested swamp
US-Myb	Unforested swamp
US-ORv	Forested swamp
US-OWC	Unforested swamp
US-Sne	Unforested swamp
US-Tw1	Unforested swamp
US-Tw4	Unforested swamp
US-Tw5	Unforested swamp
US-WPT	Unforested swamp
